111111111
10P0001E1
10101C001
101C1N001
101C00001
111111111
