111111111
10P001E01
1010CCCC1
111111111
