111111111
10P0001E1
101010001
101C10001
111111111
