111111111
1P0000E01
1010C0001
111111111