1111111111
10P01C1E01
1010100001
101C1N0001
101C000011
1111111111
