111111111
10P001E01
1010C0C01
111111111
