111111111
10P0001E1
1010100C1
101C10001
111111111
