1111111111111111111111
1C10001011101110101111
1C10101111111111111011
100000000000C0000C0111
1011101P11111010111011
1111111011101010001011
1000111011111010111011
1010101011111010101011
1110111010001110111011
1000C00C1C100000C000E1
1111111111111111111111
