1111111111111111111111
1C10001011101110101111
1C10101111111100011011
100000000000C10N0C0111
1011101P11111000011011
1111111011101010001011
1000111011111010111011
1011010111110101010011
1110111010001110111011
1000C00C1C100000C00001
1111111111111111111111
