1111111111111111111111
1010001011101110101111
101000E111111100011011
10000000000001N0000111
1011101P11111000011011
111111C011101010001011
1011010111110101010011
1110111010001110111011
1000000010100000000001
1111111111111111111111
