1111111111111111111
100C000000100000001
1000000000001000001
100000000C00000C001
1000000000000000001
1001000001110000001
10P0000000E00000C01
1111111111111111111