111111111111111111111
10E100000110000000101
101100001000100000101
100000001C01100C00101
10000000NN01000100101
100100000001C00000101
1010000010101001C0101
10C0C0C010C1C1C0C0001
100C01001010000000001
100001001000100100101
1000010011N1100C10101
100001001001000100101
1NN100001111000000101
10P0000010000100C0001
111111111111111111111
