111111111111111111111
100C00000010000000101
100000000000100000101
100000000C01100C00101
100000000001000100101
100100000111C00000101
1010000000100000C0101
10C0C0C0C0C0C0C0C0001
100C00000010000000001
100000000000100000101
100000000101100C00101
100000000001000100101
101100000111000000101
1CP0000000E00000C0001
111111111111111111111
